BDE=Balcão do Empreendedor
RJACSR=Regime Jurídico das Atividades de Comércio Serviços e Restauração
AL=Alojamento Local
RJUE=Regime Jurídico do Urbanismo e Edificação
SIR=Sistema Indústrial Responsável
OEP=Ocupação de Espaço Público
CMD=Chave Móvel Digital
iAP=Interoperabilidade na Administração Pública
EE=Espaço Empresa
EC=Espaço Cidadão
ECM=Espaço Cidadão Móvel
LC=Loja de Cidadão
PPAP=Plataforma de Pagamentos da Administração Pública
FA=Fornecedor de Autenticação
MCP=Mera Comunicação Prévia
AU=Autorização
CMP=Comunicação Prévia com Prazo
EoL=Empresa Online
IES=Informação Empresarial Simplificada
CC=Cartão de Cidadão
NIF=Número de Identificação Fiscal
NIPC=Número de Identificação de Pessoa Colectiva
NISS=Número de Identificação de Segurança Social
DEE=Dossier Eletrónico da Empresa
SILiAmb=Sistema Integrado de Licenciamento do Ambiente
LUA=Licenciamento Único Ambiental
CCE=Centro de Contacto da Empresa
CFE=Centro de Formalidades das Empresas
EPS=Entidade prestadora de Serviço
FS=Ficha de Serviço
PC=Portal do Cidadão
DR=Diário da República
DRE=Diário da república Eletrónico
DL=Decreto Lei
SAMA=Sistema de Apoios à Modernização Administrativa
RNAL=Registo Nacional de Alojamento Local
RNT=Registo Nacional de Turismo
MB=Multibanco